1111111111111
10010000000C1
10S0011000001
10P011E000001
1111111111111
