1111111111111111111111111111111111
10000000000000000000000000000000S1
1S0000000000000000CCC0000000000001
10000000000000000PCEC00000000000S1
1S0000000000000000CCC0000000000001
1111111111111111111111111111111111