1111111111111111111111111111111111
1C000000000000000000000000000000S1
1S000000000000000000000000000000C1
1C000000000000000P0E000000000000S1
1S000000000000000000000000000000C1
1111111111111111111111111111111111