1111111111111
1E010000000C1
10S0011000001
10P0110000001
1111111111111
