1111111111111111111111111111111111
1S0000000000000C00000C0000000000S1
1010010100100E00101001000000010101
1010010010101010001001000P00010101
100000000C00C000S000000000000000C1
1111111111111111111111111111111111