1111111111111111111111111111111111111111111111111
1C000000000000000000000000000000000000000000000C1
1C000000000000000000000000000000000000000000000C1
1C000000000000000000000000000000000000000S00000C1
1C000000000000000000000000000000000000000000000C1
1C00000000000000EP00000000000000000000000000000C1
1C000000000000000000000000000000000000000000000C1
1C000000000011111110011111100000000000000000000C1
1C000000000010000000010000100000000000000000000C1
1C000000000011111110010000100000000000000000000C1
1C000000000000000010010000100000000000000000000C1
1C000000000011111110011111100000000000000000000C1
1C000000000000000000000000000000000000000000000C1
1C010000001111110011000100011111000000000000000C1
1C010000001000010010100100100000000000000000000C1
1C010000001000010010010100100111000000000000000C1
1C010000001000010010001100100001000000000000000C1
1C011111001111110010000100011110000000000000000C1
1C000000000000000000000000000000000000000000000C1
1C000000000000000000000000000000000000000000000C1
1C000000000000000000000000000000000000000000000C1
1C000000000000000000000000000000000000000000000C1
1C000000000000000000000000000000000000000000000C1
1C000000000000000000000000000000000000000000000C1
1111111111111111111111111111111111111111111111111