1111111111111111111111111111111111
1S00000000111100000000100000000001
1010010100100E00101001000000010101
1010010010111110001001000000010101
1P00000000000000000000000000000001
1111111111111111111111111111111111