1111111111111111111111111111111111
1S0000000011111C00001C000000000001
10100100100E00101001000000010101
1010010010111110001001000000010101
1P0000000C00C0000000000000000000C1
1111111111111111111111111111111111