1111111111111
10010000000C1
10S00110E00P1
10P0110000001
1111111111111
