1111111111111
1P010000000C1
10000110E0001
10P0110000001
1111111111111
