111111111111111111111111111111111111111111111111111
1C00000000000000000000000000000000000000000000000C1
1C00000000000000000000000000000000000000000000000C1
1C00000000000000000000000000000000000000000000000C1
1C00000000000000000000000000000000000000000000000C1
1C00000000000000EP0000000000000000000000000000000C1
1C00000000000000000000000000000000000000000000000C1
1C00000000001111111001111110000000000000000000000C1
1C00000000001000000001000010000000000000000000000C1
1C00000000001111111001000010000000000000000000000C1
1C00000000000000001001000010000000000000000000000C1
1C00000000001111111001111110000000000000000000000C1
1C00000000000000000000000000000000000000000000000C1
1C01000000111111001100010001111100000000000000000C1
1C01000000100001001010010010000000000000000000000C1
1C01000000100001001001010010011100000000000000000C1
1C01000000100001001000110010000100000000000000000C1
1C01111100111111001000010001111000000000000000000C1
1C00000000000000000000000000000000000000000000000C1
1C00000000000000000000000000000000000000000000000C1
1C00000000000000000000000000000000000000000000000C1
1C00000000000000000000000000000000000000000000000C1
1C00000000000000000000000000000000000000000000000C1
1C00000000000000000000000000000000000000000000000C1
1C00000000000000000000000000000000000000000000000C1
1C00000000000000000000000000000000000000000000000C1
1C00000000000000000000000000000000000000000000000C1
111111111111111111111111111111111111111111111111111