1111111111111111111111111111111111
1C000000000000000E00000000000000C1
1C000000000000000P00000000000000C1
1111111111111111111111111111111111