1111111111111111111111111111111111
1C000000000000000000000000000000C1
1C000000000000000000000000000000C1
1C00000000000000EP00000000000000C1
1C000000000000000000000000000000C1
1111111111111111111111111111111111