1111111
10PC001
100E001
1000001
10S0001
1111111